1111111111
10000C0001
1001000101
101C111101
100E01P001
1111111111
